....######.....................|...................................|....................+
.#########...............###########.............................######.................+
.########..............#############......######................*##################.....+
.#######..............##############........######............################..........+
.#######...........##################...........|......######.....#############.........+
.#####............###################..........######......|..##################........+
.#####..............##################..............|......|.....############...........+
.###................#################.............######...|.........######.............+
.###.................################................|.....|........######..............+
.##................####################..............|....######........................+
.#...................................................|.....|............................+
##...................................................|######.................##.........+
#......................###.%.###...%.................|...|..................####........+
#.................%..####################......######|...|..........##############......+
#...............########################..........|..|..#######.......#############.....+
#.............#########################...........|..|.....|............##########......+
#...@......#############################..........|..|.....|........#############.......+
#########################################################################################